*****************************************
*           #       #     #   #   #     *
* ### ##### # ##### # # # # # # # # ### *
* #   #   # # #   # # # #   #   # # #   *
* # ### # # # # ### # # # ####### # # ##*
* #   # # # # # #   # # # #   #     #   *
* ### # ### # # # ### # ### # # ####### *
*   # #     #   #   # #     # # #   #   *
*#### ######### ### # ####### ### # # # *
*     #         # # # #     #     # #   *
* ##### ######### # # # ### ####### # ##*
*       #         # # #   #     #   #   *
* ######### ##### # # # ### ##### # ####*
* #       # #     #   # #   #   # # #   *
* # ##### ### ### ##### # ### # # ### # *
*   #   #     # # #   # #   # #   #   # *
*#### # ####### # # # ##### # ### # ####*
*   # #     #       #     # # #   #     *
* # # # ##### ########### # # # ####### *
* # # #       #     #     # # #     #   *
* ### ######### ### ##### # # ##### # ##*
*   # #   #     #   #   #   # #     #   *
* # # ### # ##### ### # ##### ######### *
* # #     #   # #     # #   #       #   *
* # ##### ### # ####### # # ####### # ##*
* #     # #   #           #         #   *
* ### ### # ############# ####### ##### *
* # #     #         #   # #   #   #   # *
* # ############### # # ### # ##### # # *
*                 #   #     #       #   *
*****************************************
